Магия:
	Элементы:
		Воздух - Аэротеургия (Aero)
		Электричество - Аэротеургия (Fulgur)
		
		Огонь - Пирокинетика (Piro)
		Кристалл - Пирокинетика (Imper)
		
		Камень - Геомантия (Geo)
		Металл - Геомантия (Metall)
		Яд - Геомантия (Venom)
		
		Вода - Гидрософистика (Gidro)
		Лёд - Гидрософистика (Glacio)

		Тьма - Некромантия (Necro)
		Свет - Священное дело (Lux)

		Природа - Жизнь (Arbor)
		Кровь - Жизнь (Sanguis)
		
	Запретное искусство - Исток (Fons) или Частицы элементарного взаимодействия (EI-частицы)
		Время - Запретное искусство (Tempus)
		Пространство - Запретное искусство (Locus)
		Энергия - Запретное искусство (Energia)

	Управление:
		Поглощение - Absorb
		Усиление - Amplify
		Призыв - Conjure
		Воплощение - Epitomize
		Связь - Evoke
		Наложение - Inflict
		Изменение - Transmute
	
	Форма:
		Форма - Forma
		Снаряд - Proiectum
		Купол - Domum
		Разлом - Rima
		Аура - Aura
		Клетка - Cellula